***************************************
*.***************************.........*
*.*...............*****.........*****.*
*...**.***.*****.******.*******.*****.*
******.***.*****.******.*******.*****.*
******.***.*****.******.*******.*****.*
******.....*****.**.....****......***.*
********.****....**.********.****.***.*
*****.......*.**.**.********......***.*
**....*****.*.**........****.********.*
***.*.*****.*.***.*****.****.********.*
***.*.........***.*****.............*.*
***.******.******.*****.***********.*.*
***.******.******.............*****.*.*
***........*********.********.*****.*.*
*****.****.*********.......**....**.*.*
*****.****.*********.*****.**.*****.*.*
*****.****..*.......................*.*
*****........*************.*******....*
***************************************
